230 230 60 60 80 80 80 80 80 80 80 80 80 80 80 80 80 80 80 80 80 80 70 70 70 70 70 70 70 70 230 230 230 230 230 230 230 230 230 230 230 230 230 230 230 230 230 230 230 230 230 230 230 230 230 230 230 230 230 230
230 60 60 80 70 80 80 80 80 80 80 80 80 80 80 80 80 80 80 80 70 70 70 70 70 70 70 70 70 70 230 230 230 230 230 230 230 230 230 230 230 230 230 230 230 230 230 230 230 230 230 230 230 230 230 230 230 230 230 230
225 60 80 80 70 80 80 80 80 80 80 80 80 80 80 80 80 80 80 70 70 70 70 70 70 70 70 70 70 70 230 230 230 230 230 230 230 230 230 230 230 230 230 230 230 230 230 230 230 230 230 230 230 230 230 230 230 230 230 230
60 60 80 70 80 80 80 80 80 80 80 80 80 80 80 80 80 80 80 70 70 70 70 70 70 70 70 70 70 70 230 230 230 230 230 230 230 230 230 230 230 230 230 230 230 230 230 230 230 230 230 230 230 230 230 230 230 230 230 230
60 60 70 80 80 80 80 80 80 80 80 80 80 80 80 80 80 80 70 70 70 70 70 70 70 70 70 70 70 70 230 230 230 230 230 230 230 230 230 230 230 230 230 230 230 230 230 230 230 230 230 230 230 230 230 230 230 230 230 230
60 60 80 80 80 80 80 80 80 80 80 80 80 80 80 80 80 80 70 70 70 70 70 70 70 70 70 70 70 70 230 230 230 230 230 230 230 230 230 230 230 230 230 230 230 230 230 230 230 230 230 230 230 230 230 230 230 230 230 230
60 60 80 80 80 80 80 80 80 80 80 80 80 80 80 80 80 80 70 70 70 70 70 70 70 70 70 70 70 70 230 230 230 230 230 230 230 230 230 230 230 230 230 230 230 230 230 230 230 230 230 230 230 230 230 230 230 230 230 230
60 80 70 80 80 80 80 80 80 80 80 80 80 80 80 80 80 80 70 70 70 70 70 70 70 70 70 70 70 70 230 230 230 230 230 230 230 230 230 230 230 230 230 230 230 230 230 230 230 230 230 230 230 230 230 230 230 230 230 230
60 80 80 80 80 80 80 80 80 80 80 80 80 80 80 80 80 80 70 70 70 70 70 70 70 70 70 70 70 70 230 230 230 230 230 230 230 230 230 230 230 230 230 230 230 230 230 230 230 230 230 230 230 230 230 230 230 230 230 230
60 80 80 70 80 80 80 80 80 80 80 80 80 80 80 80 80 80 80 70 70 70 70 70 70 70 70 70 70 70 230 230 230 230 230 230 230 230 230 230 230 230 230 230 230 230 230 230 230 230 230 230 230 230 230 230 230 230 230 230
60 60 80 70 80 80 80 80 80 80 80 80 80 80 80 80 80 80 80 70 70 70 70 70 70 70 70 70 70 70 230 230 230 230 230 230 230 230 230 230 230 230 230 230 230 230 230 230 230 230 230 230 230 230 230 230 230 230 230 230
60 60 60 80 70 80 80 80 80 80 80 80 80 80 80 80 80 80 70 70 70 70 70 70 70 70 70 70 70 70 230 230 230 230 230 230 230 230 230 230 230 230 230 230 230 230 230 230 230 230 230 230 230 230 230 230 230 230 230 230
60 60 80 80 80 80 80 80 80 80 80 80 80 80 80 80 80 80 70 70 70 70 70 70 70 70 70 70 70 70 230 230 230 230 230 230 230 230 230 230 230 230 230 230 230 230 230 230 230 230 230 230 230 230 230 230 230 230 230 230
60 80 80 70 80 80 80 80 80 80 80 80 80 80 80 80 80 80 70 70 70 70 70 70 70 70 70 70 70 70 230 230 230 230 230 230 230 230 230 230 230 230 230 230 230 230 230 230 230 230 230 230 230 230 230 230 230 230 230 230
60 60 80 70 80 80 80 80 80 80 80 80 80 80 80 80 80 80 70 70 70 70 70 70 70 70 70 70 70 70 230 230 230 230 230 230 230 230 230 230 230 230 230 230 230 230 230 230 230 230 230 230 230 230 230 230 230 230 230 230
60 60 80 70 80 80 80 80 80 80 80 80 80 80 80 80 80 80 70 70 70 70 70 70 70 70 70 70 70 70 230 230 230 230 230 230 230 230 230 230 230 230 230 230 230 230 230 230 230 230 230 230 230 230 230 230 230 230 230 230
60 60 80 80 80 80 80 80 80 80 80 80 80 80 80 80 80 80 70 70 70 70 70 70 70 70 70 70 70 70 230 230 230 230 230 230 230 230 230 230 230 230 230 230 230 230 230 230 230 230 230 230 230 230 230 230 230 230 230 230
60 80 80 70 80 80 80 80 80 80 80 80 80 80 80 80 80 80 80 70 70 70 70 70 70 70 70 70 70 70 230 230 230 230 230 230 230 230 230 230 230 230 230 230 230 230 230 230 230 230 230 230 230 230 230 230 230 230 230 230
60 80 70 80 80 80 80 80 80 80 80 80 80 80 80 80 80 80 80 70 70 70 70 70 70 70 70 70 70 70 230 230 230 230 230 230 230 230 230 230 230 230 230 230 230 230 230 230 230 230 230 230 230 230 230 230 230 230 230 230
60 60 80 70 80 80 80 80 80 80 80 80 80 80 80 80 80 80 70 70 70 70 70 70 70 70 70 70 70 70 230 230 230 230 230 230 230 230 230 230 230 230 230 230 230 230 230 230 230 230 230 230 230 230 230 230 230 230 230 230
60 60 80 70 80 80 80 80 80 80 80 80 80 80 80 80 80 80 70 70 70 70 70 70 70 70 70 70 70 70 230 230 230 230 230 230 230 230 230 230 230 230 230 230 230 230 230 230 230 230 230 230 230 230 230 230 230 230 230 230
60 60 80 80 80 80 80 80 80 80 80 80 80 80 80 80 80 80 70 70 70 70 70 70 70 70 70 70 70 70 230 230 230 230 230 230 230 230 230 230 230 230 230 230 230 230 230 230 230 230 230 230 230 230 230 230 230 230 230 230
60 60 80 70 80 80 80 80 80 80 80 80 80 80 80 80 80 80 70 70 70 70 70 70 70 70 70 70 70 70 230 230 230 230 230 230 230 230 230 230 230 230 230 230 230 230 230 230 230 230 230 230 230 230 230 230 230 230 230 230
60 80 80 70 80 80 80 80 80 80 80 80 80 80 80 80 80 80 70 70 70 70 70 70 70 70 70 70 70 70 230 230 230 230 230 230 230 230 230 230 230 230 230 230 230 230 230 230 230 230 230 230 230 230 230 230 230 230 230 230
60 60 80 80 80 80 80 80 80 80 80 80 80 80 80 80 80 80 80 70 70 70 70 70 70 70 70 70 70 70 230 230 230 230 230 230 230 230 230 230 230 230 230 230 230 230 230 230 230 230 230 230 230 230 230 230 230 230 230 230
60 60 70 80 80 80 80 80 80 80 80 80 80 80 80 80 80 80 80 70 70 70 70 70 70 70 70 70 70 70 230 230 230 230 230 230 230 230 230 230 230 230 230 230 230 230 230 230 230 230 230 230 230 230 230 230 230 230 230 230
60 60 60 80 70 80 80 80 80 80 80 80 80 80 80 80 80 80 80 70 70 70 70 70 70 70 70 70 70 70 230 230 230 230 230 230 230 230 230 230 230 230 230 230 230 230 230 230 230 230 230 230 230 230 230 230 230 230 230 230
60 60 80 80 80 80 80 80 80 80 80 80 80 80 80 80 80 80 80 70 70 70 70 70 70 70 70 70 70 70 230 230 230 230 230 230 230 230 230 230 230 230 230 230 230 230 230 230 230 230 230 230 230 230 230 230 230 230 230 230
230 60 60 80 70 80 80 80 80 80 80 80 80 80 80 80 80 80 80 80 70 70 70 70 70 70 70 70 70 70 230 230 230 230 230 230 230 230 230 230 230 230 230 230 230 230 230 230 230 230 230 230 230 230 230 230 230 230 230 230
230 230 225 60 60 80 80 80 80 80 80 80 80 80 80 80 80 80 80 80 80 80 70 70 70 70 70 70 70 70 230 230 230 230 230 230 230 230 230 230 230 230 230 230 230 230 230 230 230 230 230 230 230 230 230 230 230 230 230 230
230 230 230 230 230 230 230 230 230 230 230 230 230 230 230 230 230 230 230 230 230 230 230 230 230 230 230 230 230 230 230 230 230 230 230 230 230 230 230 230 230 230 230 230 230 230 230 230 230 230 230 230 230 230 230 230 230 230 230 230
230 230 230 230 230 230 230 230 230 230 230 230 230 230 230 230 230 230 230 230 230 230 230 230 230 230 230 230 230 230 230 230 230 230 230 230 230 230 230 230 230 230 230 230 230 230 230 230 230 230 230 230 230 230 230 230 230 230 230 230
230 230 230 230 230 230 230 230 230 230 230 230 230 230 230 230 230 230 230 230 230 230 230 230 230 230 60 60 80 80 230 230 230 230 230 230 230 230 230 230 230 230 230 230 230 230 230 230 230 230 230 230 230 230 230 230 230 230 230 230
230 230 230 230 230 230 230 230 230 230 230 230 230 230 230 230 230 230 230 230 230 230 230 230 230 60 60 60 80 80 230 230 230 230 230 230 230 230 230 230 230 230 230 230 230 230 230 230 230 230 230 230 230 230 230 230 230 230 230 230
230 230 230 230 230 230 230 230 230 230 230 230 230 230 230 230 230 230 230 230 230 230 230 230 230 230 230 230 60 80 230 230 230 230 230 230 230 230 230 230 230 230 230 230 230 230 230 230 230 230 230 230 230 230 230 230 230 230 230 230
230 230 230 230 230 230 230 230 230 230 230 230 230 230 230 230 230 230 230 230 230 230 230 230 230 230 60 60 60 80 230 230 230 230 230 230 230 230 230 230 230 230 230 230 230 230 230 230 230 230 230 230 230 230 230 230 230 230 230 230
230 230 230 230 230 230 230 230 230 230 230 230 230 230 230 230 230 230 230 230 230 230 230 230 230 230 230 60 60 80 230 230 230 230 230 230 230 230 230 230 230 230 230 230 230 230 230 230 230 230 230 230 230 230 230 230 230 230 230 230
230 230 230 230 230 230 230 230 230 230 230 230 230 230 230 230 230 230 230 230 230 230 230 230 230 230 230 230 230 80 230 230 230 230 230 230 230 230 230 230 230 230 230 230 230 230 230 230 230 230 230 230 230 230 230 230 230 230 230 230
230 230 230 230 230 230 230 230 230 230 230 230 230 230 230 230 230 230 230 230 230 230 230 230 230 230 230 230 230 230 230 230 230 230 230 230 230 230 230 230 230 230 230 230 230 230 230 230 230 230 230 230 230 230 230 230 230 230 230 230
230 230 230 230 230 230 230 230 230 230 230 230 230 230 230 230 230 230 230 230 230 230 230 230 230 230 230 230 230 230 230 230 230 230 230 230 230 230 230 230 230 230 230 230 230 230 230 230 230 230 230 230 230 230 230 230 230 230 230 230
230 230 230 230 230 230 230 230 230 230 230 230 230 230 230 230 230 230 230 230 230 230 230 230 230 230 230 80 80 80 230 230 230 230 230 230 230 230 230 230 230 230 230 230 230 230 230 230 230 230 230 230 230 230 230 230 230 230 230 230
230 230 230 230 230 230 230 230 230 230 230 230 230 230 230 230 230 230 230 230 230 230 230 230 230 60 60 80 80 80 230 230 230 230 230 230 230 230 230 230 230 230 230 230 230 230 230 230 230 230 230 230 230 230 230 230 230 230 230 230
230 230 230 230 230 230 230 230 230 230 230 230 230 230 230 230 230 230 230 230 230 230 230 230 60 60 60 60 80 80 230 230 230 230 230 230 230 230 230 230 230 230 230 230 230 230 230 230 230 230 230 230 230 230 230 230 230 230 230 230
230 230 230 230 230 230 230 230 230 230 230 230 230 230 230 230 230 230 230 230 230 230 230 230 60 60 60 60 60 80 230 230 230 230 230 230 230 230 230 230 230 230 230 230 230 230 230 230 230 230 230 230 230 230 230 230 230 230 230 230
230 230 230 230 230 230 230 230 230 230 230 230 230 230 230 230 230 230 230 230 230 230 230 230 60 60 60 80 80 80 230 230 230 230 230 230 230 230 230 230 230 230 230 230 230 230 230 230 230 230 230 230 230 230 230 230 230 230 230 230
230 230 230 230 230 230 230 230 230 230 230 230 230 230 230 230 230 230 230 230 230 230 230 230 60 60 60 60 80 80 230 230 230 230 230 230 230 230 230 230 230 230 230 230 230 230 230 230 230 230 230 230 230 230 230 230 230 230 230 230
230 230 230 230 230 230 230 230 230 230 230 230 230 230 230 230 230 230 230 230 230 230 230 230 60 60 60 80 80 80 230 230 230 230 230 230 230 230 230 230 230 230 230 230 230 230 230 230 230 230 230 230 230 230 230 230 230 230 230 230
230 230 230 230 230 230 230 230 230 230 230 230 230 230 230 230 230 230 230 230 230 230 230 230 60 60 60 80 80 80 230 230 230 230 230 230 230 230 230 230 230 230 230 230 230 230 230 230 230 230 230 230 230 230 230 230 230 230 230 230
230 230 230 230 230 230 230 230 230 230 230 230 230 230 230 230 230 230 230 230 230 230 230 230 230 60 60 80 80 80 230 230 230 230 230 230 230 230 230 230 230 230 230 230 230 230 230 230 230 230 230 230 230 230 230 230 230 230 230 230
230 230 230 230 230 230 230 230 230 230 230 230 230 230 230 230 230 230 230 230 230 230 230 230 230 230 225 60 80 80 230 230 230 230 230 230 230 230 230 230 230 230 230 230 230 230 230 230 230 230 230 230 230 230 230 230 230 230 230 230
70 70 70 70 80 80 80 80 175 175 230 230 230 230 230 230 230 230 230 230 230 60 80 80 80 60 230 230 230 230 230 230 230 230 230 230 230 230 230 230 230 230 230 230 230 230 230 230 230 230 230 230 230 230 230 230 230 230 230 230
70 70 70 70 80 80 80 80 175 175 230 230 230 230 230 230 230 230 230 60 60 60 80 70 70 80 230 230 230 230 230 230 230 230 230 230 230 230 230 230 230 230 230 230 230 230 230 230 230 230 230 230 230 230 230 230 230 230 230 230
70 70 70 70 80 80 80 80 175 175 230 230 230 230 230 230 230 230 60 60 80 80 70 80 80 80 60 230 230 230 230 230 230 230 230 230 230 230 230 230 230 230 230 230 230 230 230 230 230 230 230 230 230 230 230 230 230 230 230 230
70 70 70 70 80 80 80 80 175 175 230 230 230 230 230 230 230 230 60 60 80 80 80 80 80 80 80 230 230 70 230 230 230 230 230 230 230 230 230 230 230 230 230 230 230 230 230 230 230 230 230 230 230 230 230 230 230 230 230 230
80 80 80 80 80 80 80 80 195 195 230 230 230 230 230 230 230 230 60 60 80 80 80 80 80 80 80 80 80 70 230 230 230 230 230 230 230 230 230 230 230 230 230 230 230 230 230 230 230 230 230 230 230 230 230 230 230 230 230 230
80 80 80 80 80 80 80 80 195 195 230 230 230 230 230 230 230 230 60 60 80 70 80 80 80 80 80 80 70 70 230 230 230 230 230 230 230 230 230 230 230 230 230 230 230 230 230 230 230 230 230 230 230 230 230 230 230 230 230 230
80 80 80 80 80 80 80 80 195 195 230 230 230 230 230 230 230 230 60 80 80 80 80 80 80 80 70 70 70 70 230 230 230 230 230 230 230 230 230 230 230 230 230 230 230 230 230 230 230 230 230 230 230 230 230 230 230 230 230 230
80 80 80 80 80 80 80 80 195 195 230 230 230 230 230 230 230 230 230 60 80 70 80 80 80 60 60 230 230 70 230 230 230 230 230 230 230 230 230 230 230 230 230 230 230 230 230 230 230 230 230 230 230 230 230 230 230 230 230 230
80 80 80 80 60 60 60 60 205 205 230 230 230 230 230 230 230 230 230 230 60 80 80 70 60 60 230 230 230 230 230 230 230 230 230 230 230 230 230 230 230 230 230 230 230 230 230 230 230 230 230 230 230 230 230 230 230 230 230 230
80 80 80 80 60 60 60 60 205 205 230 230 230 230 230 230 230 230 230 230 230 60 60 60 60 230 230 230 230 230 230 230 230 230 230 230 230 230 230 230 230 230 230 230 230 230 230 230 230 230 230 230 230 230 230 230 230 230 230 230
80 80 80 80 60 60 60 60 205 205 230 230 230 230 230 230 230 230 230 230 230 230 230 230 230 230 230 230 230 230 230 230 230 230 230 230 230 230 230 230 230 230 230 230 230 230 230 230 230 230 230 230 230 230 230 230 230 230 230 230
80 80 80 80 60 60 60 60 205 205 230 230 230 230 230 230 230 230 230 230 230 230 230 230 230 230 230 230 205 195 230 230 230 230 230 230 230 230 230 230 230 230 230 230 230 230 230 230 230 230 230 230 230 230 230 230 230 230 230 230
90 90 90 90 60 60 60 60 215 215 230 230 230 230 230 230 230 230 230 230 230 230 230 230 230 230 230 225 195 195 230 230 230 230 230 230 230 230 230 230 230 230 230 230 230 230 230 230 230 230 230 230 230 230 230 230 230 230 230 230
90 90 90 90 60 60 60 60 215 215 230 230 230 230 230 230 230 230 230 230 230 230 230 230 230 230 230 205 195 175 230 230 230 230 230 230 230 230 230 230 230 230 230 230 230 230 230 230 230 230 230 230 230 230 230 230 230 230 230 230
90 90 90 90 60 60 60 60 215 215 230 230 230 230 230 230 230 230 230 230 230 230 230 230 230 230 230 205 195 175 230 230 230 230 230 230 230 230 230 230 230 230 230 230 230 230 230 230 230 230 230 230 230 230 230 230 230 230 230 230
90 90 90 90 60 60 60 60 215 215 230 230 230 230 230 230 230 230 230 230 230 230 230 230 230 230 230 230 205 195 230 230 230 230 230 230 230 230 230 230 230 230 230 230 230 230 230 230 230 230 230 230 230 230 230 230 230 230 230 230
100 100 100 100 225 225 225 225 225 225 230 230 230 230 230 230 230 230 230 230 230 230 230 230 230 230 230 230 230 230 230 230 230 230 230 230 10 230 230 230 230 230 230 230 230 230 230 230 230 230 230 230 230 230 230 230 230 230 230 230
100 100 100 100 225 225 225 225 225 225 230 230 230 230 230 230 230 230 230 230 230 230 230 230 230 230 230 230 230 230 230 230 230 230 230 230 230 230 230 230 230 230 230 230 230 230 230 230 230 230 230 230 230 230 230 230 230 230 230 230
100 100 100 100 225 225 225 225 225 225 230 230 230 230 230 230 230 230 230 230 230 230 230 230 230 230 230 230 230 230 230 230 230 230 230 230 60 60 230 230 230 230 230 230 230 230 230 230 230 230 230 230 230 230 230 230 230 230 230 230
100 100 100 100 225 225 225 225 225 225 230 230 230 230 230 230 230 230 230 230 230 230 230 230 230 230 230 230 230 230 230 230 230 230 230 230 230 60 60 230 230 230 230 230 230 230 230 230 230 230 230 230 230 230 230 230 230 230 230 230
230 230 230 230 230 230 230 230 230 230 230 230 230 230 230 230 230 230 230 230 230 230 230 230 230 230 230 230 230 230 230 230 230 230 230 230 230 60 230 230 230 230 230 230 230 230 230 230 230 230 230 230 230 230 230 230 230 230 230 230
230 230 230 230 230 230 230 230 230 230 230 230 230 230 230 230 230 230 230 230 230 230 230 230 230 230 230 230 230 230 230 230 230 230 230 230 230 230 230 20 230 230 230 230 230 230 230 230 230 230 230 230 230 230 230 230 230 230 230 230
230 230 230 230 230 230 230 230 230 230 230 230 230 230 230 230 230 230 230 230 230 230 230 230 230 230 230 230 230 230 230 230 230 230 230 230 230 230 70 40 230 230 230 230 230 230 230 230 230 230 230 230 230 230 230 230 230 230 230 230
230 230 230 230 230 230 230 230 230 230 230 230 230 230 230 230 230 230 230 230 230 230 230 230 230 230 230 215 205 205 230 230 230 230 230 230 230 230 230 230 230 230 230 230 230 230 230 230 230 230 230 230 230 230 230 230 230 230 230 230
230 230 230 230 230 230 230 230 230 230 230 230 230 230 230 230 230 230 230 230 230 230 230 225 215 205 205 195 195 195 230 230 230 230 230 230 230 230 230 230 230 230 230 230 230 230 230 230 230 230 230 230 230 230 230 230 230 230 230 230
230 230 230 230 230 230 230 230 230 230 230 230 230 230 230 230 230 230 230 230 230 230 225 215 205 195 195 195 195 175 230 230 230 230 230 230 230 230 230 230 230 230 230 230 230 230 230 230 230 230 230 230 230 230 230 230 230 230 230 230
230 230 230 230 230 230 230 230 230 230 230 230 230 230 230 230 230 230 230 230 230 230 225 215 205 195 195 175 175 175 230 230 230 230 230 230 230 230 230 230 230 230 230 230 230 230 230 230 230 230 230 230 230 230 230 230 230 230 230 230
230 230 230 230 230 230 230 230 230 230 230 230 230 230 230 230 230 230 230 230 230 230 230 215 215 195 195 195 175 175 230 230 230 230 230 230 230 230 230 230 230 230 230 230 230 230 230 230 230 230 230 230 230 230 230 230 230 230 230 230
230 230 230 230 230 230 230 230 230 230 230 230 230 230 230 230 230 230 230 230 230 230 230 230 225 205 205 195 195 195 230 230 230 230 230 230 230 230 230 230 230 230 230 230 230 230 230 230 230 230 230 230 230 230 230 230 230 230 230 230
230 230 230 230 230 230 230 230 230 230 230 230 230 230 230 230 230 230 230 230 230 230 230 230 230 230 230 230 230 230 230 230 230 230 230 230 230 230 230 230 230 230 230 230 230 230 230 230 230 230 230 230 230 230 230 230 230 230 230 230
