173 173 140 140 110 155 155 155 155 155 155 155 155 145 145 145 145 145 145 145 145 145 135 135 135 135 135 135 135 135 173 173 173 173 173 173 173 173 173 173 173 173 173 173 173 173 173 173 173 173 173 173 173 173 173 173 173 173 173 173
173 140 140 110 135 145 155 155 155 155 155 145 145 145 145 145 145 145 145 145 135 135 135 135 135 135 135 135 135 135 173 173 173 173 173 173 173 173 173 173 173 173 173 173 173 173 173 173 173 173 173 173 173 173 173 173 173 173 173 173
225 140 110 110 135 145 155 155 155 155 145 145 145 145 145 145 145 145 145 135 135 135 135 135 135 135 135 135 135 135 173 173 173 173 173 173 173 173 173 173 173 173 173 173 173 173 173 173 173 173 173 173 173 173 173 173 173 173 173 173
140 140 110 135 145 155 155 155 155 155 145 145 145 145 145 145 145 145 145 135 135 135 135 135 135 135 135 135 135 135 173 173 173 173 173 173 173 173 173 173 173 173 173 173 173 173 173 173 173 173 173 173 173 173 173 173 173 173 173 173
140 140 135 145 145 155 155 155 155 155 145 145 145 145 145 145 145 145 135 135 135 135 135 135 135 135 135 135 135 135 173 173 173 173 173 173 173 173 173 173 173 173 173 173 173 173 173 173 173 173 173 173 173 173 173 173 173 173 173 173
140 140 110 145 145 155 155 155 155 155 145 145 145 145 145 145 145 145 135 135 135 135 135 135 135 135 135 135 135 135 173 173 173 173 173 173 173 173 173 173 173 173 173 173 173 173 173 173 173 173 173 173 173 173 173 173 173 173 173 173
140 140 110 145 145 155 155 155 155 155 145 145 145 145 145 145 145 145 135 135 135 135 135 135 135 135 135 135 135 135 173 173 173 173 173 173 173 173 173 173 173 173 173 173 173 173 173 173 173 173 173 173 173 173 173 173 173 173 173 173
140 110 135 145 145 155 155 155 155 155 145 145 145 145 145 145 145 145 135 135 135 135 135 135 135 135 135 135 135 135 173 173 173 173 173 173 173 173 173 173 173 173 173 173 173 173 173 173 173 173 173 173 173 173 173 173 173 173 173 173
140 110 110 110 145 155 155 155 155 155 155 145 145 145 145 145 145 145 135 135 135 135 135 135 135 135 135 135 135 135 173 173 173 173 173 173 173 173 173 173 173 173 173 173 173 173 173 173 173 173 173 173 173 173 173 173 173 173 173 173
140 110 110 135 145 145 155 155 155 155 155 145 145 145 145 145 145 145 145 135 135 135 135 135 135 135 135 135 135 135 173 173 173 173 173 173 173 173 173 173 173 173 173 173 173 173 173 173 173 173 173 173 173 173 173 173 173 173 173 173
140 140 110 135 145 145 155 155 155 155 145 145 145 145 145 145 145 145 145 135 135 135 135 135 135 135 135 135 135 135 173 173 173 173 173 173 173 173 173 173 173 173 173 173 173 173 173 173 173 173 173 173 173 173 173 173 173 173 173 173
140 140 140 110 135 155 155 155 155 155 155 145 145 145 145 145 145 145 135 135 135 135 135 135 135 135 135 135 135 135 173 173 173 173 173 173 173 173 173 173 173 173 173 173 173 173 173 173 173 173 173 173 173 173 173 173 173 173 173 173
140 140 110 110 145 155 155 155 155 155 145 145 145 145 145 145 145 145 135 135 135 135 135 135 135 135 135 135 135 135 173 173 173 173 173 173 173 173 173 173 173 173 173 173 173 173 173 173 173 173 173 173 173 173 173 173 173 173 173 173
140 110 110 135 145 155 155 155 155 145 145 145 145 145 145 145 145 145 135 135 135 135 135 135 135 135 135 135 135 135 173 173 173 173 173 173 173 173 173 173 173 173 173 173 173 173 173 173 173 173 173 173 173 173 173 173 173 173 173 173
140 140 110 135 145 155 155 155 155 155 145 145 145 145 145 145 145 145 135 135 135 135 135 135 135 135 135 135 135 135 173 173 173 173 173 173 173 173 173 173 173 173 173 173 173 173 173 173 173 173 173 173 173 173 173 173 173 173 173 173
140 140 110 135 145 155 155 155 155 145 145 145 145 145 145 145 145 145 135 135 135 135 135 135 135 135 135 135 135 135 173 173 173 173 173 173 173 173 173 173 173 173 173 173 173 173 173 173 173 173 173 173 173 173 173 173 173 173 173 173
140 140 110 110 145 155 155 155 155 145 145 145 145 145 145 145 145 145 135 135 135 135 135 135 135 135 135 135 135 135 173 173 173 173 173 173 173 173 173 173 173 173 173 173 173 173 173 173 173 173 173 173 173 173 173 173 173 173 173 173
140 110 110 135 145 155 155 155 155 145 145 145 145 145 145 145 145 145 145 135 135 135 135 135 135 135 135 135 135 135 173 173 173 173 173 173 173 173 173 173 173 173 173 173 173 173 173 173 173 173 173 173 173 173 173 173 173 173 173 173
140 110 135 145 145 155 155 155 155 155 145 145 145 145 145 145 145 145 145 135 135 135 135 135 135 135 135 135 135 135 173 173 173 173 173 173 173 173 173 173 173 173 173 173 173 173 173 173 173 173 173 173 173 173 173 173 173 173 173 173
140 140 110 135 145 155 155 155 155 155 145 145 145 145 145 145 145 145 135 135 135 135 135 135 135 135 135 135 135 135 173 173 173 173 173 173 173 173 173 173 173 173 173 173 173 173 173 173 173 173 173 173 173 173 173 173 173 173 173 173
140 140 110 135 145 155 155 155 155 155 145 145 145 145 145 145 145 145 135 135 135 135 135 135 135 135 135 135 135 135 173 173 173 173 173 173 173 173 173 173 173 173 173 173 173 173 173 173 173 173 173 173 173 173 173 173 173 173 173 173
140 140 110 110 145 155 155 155 155 155 155 145 145 145 145 145 145 145 135 135 135 135 135 135 135 135 135 135 135 135 173 173 173 173 173 173 173 173 173 173 173 173 173 173 173 173 173 173 173 173 173 173 173 173 173 173 173 173 173 173
140 140 110 135 145 155 155 155 155 155 155 145 145 145 145 145 145 145 135 135 135 135 135 135 135 135 135 135 135 135 173 173 173 173 173 173 173 173 173 173 173 173 173 173 173 173 173 173 173 173 173 173 173 173 173 173 173 173 173 173
140 110 110 135 145 155 155 155 155 155 145 145 145 145 145 145 145 145 135 135 135 135 135 135 135 135 135 135 135 135 173 173 173 173 173 173 173 173 173 173 173 173 173 173 173 173 173 173 173 173 173 173 173 173 173 173 173 173 173 173
140 140 110 145 155 155 155 155 155 155 145 145 145 145 145 145 145 145 145 135 135 135 135 135 135 135 135 135 135 135 173 173 173 173 173 173 173 173 173 173 173 173 173 173 173 173 173 173 173 173 173 173 173 173 173 173 173 173 173 173
140 140 135 145 145 155 155 155 155 155 155 145 145 145 145 145 145 145 145 135 135 135 135 135 135 135 135 135 135 135 173 173 173 173 173 173 173 173 173 173 173 173 173 173 173 173 173 173 173 173 173 173 173 173 173 173 173 173 173 173
140 140 140 110 135 145 155 155 155 155 155 145 145 145 145 145 145 145 145 135 135 135 135 135 135 135 135 135 135 135 173 173 173 173 173 173 173 173 173 173 173 173 173 173 173 173 173 173 173 173 173 173 173 173 173 173 173 173 173 173
140 140 110 110 110 145 155 155 155 155 145 145 145 145 145 145 145 145 145 135 135 135 135 135 135 135 135 135 135 135 173 173 173 173 173 173 173 173 173 173 173 173 173 173 173 173 173 173 173 173 173 173 173 173 173 173 173 173 173 173
173 140 140 110 135 145 155 155 155 155 155 145 145 145 145 145 145 145 145 145 135 135 135 135 135 135 135 135 135 135 173 173 173 173 173 173 173 173 173 173 173 173 173 173 173 173 173 173 173 173 173 173 173 173 173 173 173 173 173 173
173 173 225 140 140 145 145 155 155 155 155 155 145 145 145 145 145 145 145 145 145 145 135 135 135 135 135 135 135 135 173 173 173 173 173 173 173 173 173 173 173 173 173 173 173 173 173 173 173 173 173 173 173 173 173 173 173 173 173 173
173 173 173 173 173 173 173 173 173 173 173 173 173 173 173 173 173 173 173 173 173 173 173 173 173 173 173 173 173 173 173 173 173 173 173 173 173 173 173 173 173 173 173 173 173 173 173 173 173 173 173 173 173 173 173 173 173 173 173 173
173 173 173 173 173 173 173 173 173 173 173 173 173 173 173 173 173 173 173 173 173 173 173 173 173 173 173 173 173 173 173 173 173 173 173 173 173 173 173 173 173 173 173 173 173 173 173 173 173 173 173 173 173 173 173 173 173 173 173 173
173 173 173 173 173 173 173 173 173 173 173 173 173 173 173 173 173 173 173 173 173 173 173 173 173 173 140 140 110 110 173 173 173 173 173 173 173 173 173 173 173 173 173 173 173 173 173 173 173 173 173 173 173 173 173 173 173 173 173 173
173 173 173 173 173 173 173 173 173 173 173 173 173 173 173 173 173 173 173 173 173 173 173 173 173 140 140 140 110 110 173 173 173 173 173 173 173 173 173 173 173 173 173 173 173 173 173 173 173 173 173 173 173 173 173 173 173 173 173 173
173 173 173 173 173 173 173 173 173 173 173 173 173 173 173 173 173 173 173 173 173 173 173 173 173 173 173 173 140 110 173 173 173 173 173 173 173 173 173 173 173 173 173 173 173 173 173 173 173 173 173 173 173 173 173 173 173 173 173 173
173 173 173 173 173 173 173 173 173 173 173 173 173 173 173 173 173 173 173 173 173 173 173 173 173 173 140 140 140 110 173 173 173 173 173 173 173 173 173 173 173 173 173 173 173 173 173 173 173 173 173 173 173 173 173 173 173 173 173 173
173 173 173 173 173 173 173 173 173 173 173 173 173 173 173 173 173 173 173 173 173 173 173 173 173 173 173 140 140 110 173 173 173 173 173 173 173 173 173 173 173 173 173 173 173 173 173 173 173 173 173 173 173 173 173 173 173 173 173 173
173 173 173 173 173 173 173 173 173 173 173 173 173 173 173 173 173 173 173 173 173 173 173 173 173 173 173 173 173 110 173 173 173 173 173 173 173 173 173 173 173 173 173 173 173 173 173 173 173 173 173 173 173 173 173 173 173 173 173 173
173 173 173 173 173 173 173 173 173 173 173 173 173 173 173 173 173 173 173 173 173 173 173 173 173 173 173 173 173 173 173 173 173 173 173 173 173 173 173 173 173 173 173 173 173 173 173 173 173 173 173 173 173 173 173 173 173 173 173 173
173 173 173 173 173 173 173 173 173 173 173 173 173 173 173 173 173 173 173 173 173 173 173 173 173 173 173 173 173 173 173 173 173 173 173 173 173 173 173 173 173 173 173 173 173 173 173 173 173 173 173 173 173 173 173 173 173 173 173 173
173 173 173 173 173 173 173 173 173 173 173 173 173 173 173 173 173 173 173 173 173 173 173 173 173 173 173 110 110 110 173 173 173 173 173 173 173 173 173 173 173 173 173 173 173 173 173 173 173 173 173 173 173 173 173 173 173 173 173 173
173 173 173 173 173 173 173 173 173 173 173 173 173 173 173 173 173 173 173 173 173 173 173 173 173 140 140 110 110 110 173 173 173 173 173 173 173 173 173 173 173 173 173 173 173 173 173 173 173 173 173 173 173 173 173 173 173 173 173 173
173 173 173 173 173 173 173 173 173 173 173 173 173 173 173 173 173 173 173 173 173 173 173 173 140 140 140 140 110 110 173 173 173 173 173 173 173 173 173 173 173 173 173 173 173 173 173 173 173 173 173 173 173 173 173 173 173 173 173 173
173 173 173 173 173 173 173 173 173 173 173 173 173 173 173 173 173 173 173 173 173 173 173 173 140 140 140 140 140 110 173 173 173 173 173 173 173 173 173 173 173 173 173 173 173 173 173 173 173 173 173 173 173 173 173 173 173 173 173 173
173 173 173 173 173 173 173 173 173 173 173 173 173 173 173 173 173 173 173 173 173 173 173 173 140 140 140 110 110 110 173 173 173 173 173 173 173 173 173 173 173 173 173 173 173 173 173 173 173 173 173 173 173 173 173 173 173 173 173 173
173 173 173 173 173 173 173 173 173 173 173 173 173 173 173 173 173 173 173 173 173 173 173 173 140 140 140 140 110 110 173 173 173 173 173 173 173 173 173 173 173 173 173 173 173 173 173 173 173 173 173 173 173 173 173 173 173 173 173 173
173 173 173 173 173 173 173 173 173 173 173 173 173 173 173 173 173 173 173 173 173 173 173 173 140 140 140 110 110 110 173 173 173 173 173 173 173 173 173 173 173 173 173 173 173 173 173 173 173 173 173 173 173 173 173 173 173 173 173 173
173 173 173 173 173 173 173 173 173 173 173 173 173 173 173 173 173 173 173 173 173 173 173 173 140 140 140 110 110 110 173 173 173 173 173 173 173 173 173 173 173 173 173 173 173 173 173 173 173 173 173 173 173 173 173 173 173 173 173 173
173 173 173 173 173 173 173 173 173 173 173 173 173 173 173 173 173 173 173 173 173 173 173 173 173 140 140 110 110 110 173 173 173 173 173 173 173 173 173 173 173 173 173 173 173 173 173 173 173 173 173 173 173 173 173 173 173 173 173 173
173 173 173 173 173 173 173 173 173 173 173 173 173 173 173 173 173 173 173 173 173 173 173 173 173 173 225 140 110 110 173 173 173 173 173 173 173 173 173 173 173 173 173 173 173 173 173 173 173 173 173 173 173 173 173 173 173 173 173 173
135 135 135 135 110 110 110 110 175 175 173 173 173 173 173 173 173 173 173 173 173 140 110 110 110 140 173 173 173 173 173 173 173 173 173 173 173 173 173 173 173 173 173 173 173 173 173 173 173 173 173 173 173 173 173 173 173 173 173 173
135 135 135 135 110 110 110 110 175 175 173 173 173 173 173 173 173 173 173 140 140 140 110 135 135 110 173 173 173 173 173 173 173 173 173 173 173 173 173 173 173 173 173 173 173 173 173 173 173 173 173 173 173 173 173 173 173 173 173 173
135 135 135 135 110 110 110 110 175 175 173 173 173 173 173 173 173 173 140 140 110 110 225 110 145 110 140 173 173 173 173 173 173 173 173 173 173 173 173 173 173 173 173 173 173 173 173 173 173 173 173 173 173 173 173 173 173 173 173 173
135 135 135 135 110 110 110 110 175 175 173 173 173 173 173 173 173 173 140 140 110 110 110 110 145 155 110 173 173 135 173 173 173 173 173 173 173 173 173 173 173 173 173 173 173 173 173 173 173 173 173 173 173 173 173 173 173 173 173 173
145 145 145 145 110 110 110 110 195 195 173 173 173 173 173 173 173 173 140 140 110 110 110 110 145 145 145 155 155 135 173 173 173 173 173 173 173 173 173 173 173 173 173 173 173 173 173 173 173 173 173 173 173 173 173 173 173 173 173 173
145 145 145 145 110 110 110 110 195 195 173 173 173 173 173 173 173 173 140 140 110 135 145 145 145 145 145 145 135 135 173 173 173 173 173 173 173 173 173 173 173 173 173 173 173 173 173 173 173 173 173 173 173 173 173 173 173 173 173 173
145 145 145 145 110 110 110 110 195 195 173 173 173 173 173 173 173 173 140 110 110 110 145 110 110 110 135 135 135 135 173 173 173 173 173 173 173 173 173 173 173 173 173 173 173 173 173 173 173 173 173 173 173 173 173 173 173 173 173 173
145 145 145 145 110 110 110 110 195 195 173 173 173 173 173 173 173 173 173 140 110 135 110 110 110 140 140 173 173 135 173 173 173 173 173 173 173 173 173 173 173 173 173 173 173 173 173 173 173 173 173 173 173 173 173 173 173 173 173 173
155 155 155 155 140 140 140 140 205 205 173 173 173 173 173 173 173 173 173 173 140 110 110 225 140 140 173 173 173 173 173 173 173 173 173 173 173 173 173 173 173 173 173 173 173 173 173 173 173 173 173 173 173 173 173 173 173 173 173 173
155 155 155 155 140 140 140 140 205 205 173 173 173 173 173 173 173 173 173 173 173 140 140 140 140 173 173 173 173 173 173 173 173 173 173 173 173 173 173 173 173 173 173 173 173 173 173 173 173 173 173 173 173 173 173 173 173 173 173 173
155 155 155 155 140 140 140 140 205 205 173 173 173 173 173 173 173 173 173 173 173 173 173 173 173 173 173 173 173 173 173 173 173 173 173 173 173 173 173 173 173 173 173 173 173 173 173 173 173 173 173 173 173 173 173 173 173 173 173 173
155 155 155 155 140 140 140 140 205 205 173 173 173 173 173 173 173 173 173 173 173 173 173 173 173 173 173 173 205 195 173 173 173 173 173 173 173 173 173 173 173 173 173 173 173 173 173 173 173 173 173 173 173 173 173 173 173 173 173 173
165 165 165 165 140 140 140 140 215 215 173 173 173 173 173 173 173 173 173 173 173 173 173 173 173 173 173 225 195 195 173 173 173 173 173 173 173 173 173 173 173 173 173 173 173 173 173 173 173 173 173 173 173 173 173 173 173 173 173 173
165 165 165 165 140 140 140 140 215 215 173 173 173 173 173 173 173 173 173 173 173 173 173 173 173 173 173 205 195 175 173 173 173 173 173 173 173 173 173 173 173 173 173 173 173 173 173 173 173 173 173 173 173 173 173 173 173 173 173 173
165 165 165 165 140 140 140 140 215 215 173 173 173 173 173 173 173 173 173 173 173 173 173 173 173 173 173 205 195 175 173 173 173 173 173 173 245 173 173 173 173 173 173 173 173 173 173 173 173 173 173 173 173 173 173 173 173 173 173 173
165 165 165 165 140 140 140 140 215 215 173 173 173 173 173 173 173 173 173 173 173 173 173 173 173 173 173 173 205 195 173 173 173 173 173 173 255 173 173 173 173 173 173 173 173 173 173 173 173 173 173 173 173 173 173 173 173 173 173 173
175 175 175 175 225 225 225 225 225 225 173 173 173 173 173 173 173 173 173 173 173 173 173 173 173 173 173 173 173 173 173 173 173 173 173 173 245 173 173 173 173 173 173 173 173 173 173 173 173 173 173 173 173 173 173 173 173 173 173 173
175 175 175 175 225 225 225 225 225 225 173 173 173 173 173 173 173 173 173 173 173 173 173 173 173 173 173 173 173 173 173 173 173 173 173 173 255 173 173 173 173 173 173 173 173 173 173 173 173 173 173 173 173 173 173 173 173 173 173 173
175 175 175 175 225 225 225 225 225 225 173 173 173 173 173 173 173 173 173 173 173 173 173 173 173 173 173 173 173 173 173 173 173 173 173 173 255 255 255 173 173 173 173 173 173 173 173 173 173 173 173 173 173 173 173 173 173 173 173 173
175 175 175 175 225 225 225 225 225 225 173 173 173 173 173 173 173 173 173 173 173 173 173 173 173 173 173 173 173 173 173 173 173 173 173 173 173 225 225 173 173 173 173 173 173 173 173 173 173 173 173 173 173 173 173 173 173 173 173 173
173 173 173 173 173 173 173 173 173 173 173 173 173 173 173 173 173 173 173 173 173 173 173 173 173 173 173 173 173 173 173 173 173 173 173 173 173 225 255 173 173 173 173 173 173 173 173 173 173 173 173 173 173 173 173 173 173 173 173 173
173 173 173 173 173 173 173 173 173 173 173 173 173 173 173 173 173 173 173 173 173 173 173 173 173 173 173 173 173 173 173 173 173 173 173 173 173 255 255 225 173 173 173 173 173 173 173 173 173 173 173 173 173 173 173 173 173 173 173 173
173 173 173 173 173 173 173 173 173 173 173 173 173 173 173 173 173 173 173 173 173 173 173 173 173 173 173 173 173 173 173 173 173 173 173 173 173 173 225 225 173 173 173 173 173 173 173 173 173 173 173 173 173 173 173 173 173 173 173 173
173 173 173 173 173 173 173 173 173 173 173 173 173 173 173 173 173 173 173 173 173 173 173 173 173 173 173 215 205 205 173 173 173 173 173 173 173 173 173 173 173 173 173 173 173 173 173 173 173 173 173 173 173 173 173 173 173 173 173 173
173 173 173 173 173 173 173 173 173 173 173 173 173 173 173 173 173 173 173 173 173 173 173 225 215 205 205 195 195 195 173 173 173 173 173 173 173 173 173 173 173 173 173 173 173 173 173 173 173 173 173 173 173 173 173 173 173 173 173 173
173 173 173 173 173 173 173 173 173 173 173 173 173 173 173 173 173 173 173 173 173 173 225 215 205 195 195 195 195 175 173 173 173 173 173 173 173 173 173 173 173 173 173 173 173 173 173 173 173 173 173 173 173 173 173 173 173 173 173 173
173 173 173 173 173 173 173 173 173 173 173 173 173 173 173 173 173 173 173 173 173 173 225 215 205 195 195 175 175 175 173 173 173 173 173 173 173 173 173 173 173 173 173 173 173 173 173 173 173 173 173 173 173 173 173 173 173 173 173 173
173 173 173 173 173 173 173 173 173 173 173 173 173 173 173 173 173 173 173 173 173 173 173 215 215 195 195 195 175 175 173 173 173 173 173 173 173 173 173 173 173 173 173 173 173 173 173 173 173 173 173 173 173 173 173 173 173 173 173 173
173 173 173 173 173 173 173 173 173 173 173 173 173 173 173 173 173 173 173 173 173 173 173 173 225 205 205 195 195 195 173 173 173 173 173 173 173 173 173 173 173 173 173 173 173 173 173 173 173 173 173 173 173 173 173 173 173 173 173 173
173 173 173 173 173 173 173 173 173 173 173 173 173 173 173 173 173 173 173 173 173 173 173 173 173 173 173 173 173 173 173 173 173 173 173 173 173 173 173 173 173 173 173 173 173 173 173 173 173 173 173 173 173 173 173 173 173 173 173 173
